www____www
_______2__
_w______w_
__________
...____...
...____...
__________
_w______w_
__1_______
www____www
