www____www
_______1__
_w______w_
_h________
..._e__...
...__e_...
________h_
_w______w_
__2_______
www____www
