www____www
_______1__
_w______w_
__________
..._eh_...
..._he_...
__________
_w______w_
__2_______
www____www
