w__wwww__w
________1_
w___ww___w
___b__b___
.ww_.._ww.
.ww_.._ww.
___b__b___
w___ww___w
_2________
w__wwww__w
