w__wwww__w
________1_
w___ww___w
___h__e___
.ww_.._ww.
.ww_.._ww.
___e__h___
w___ww___w
_2________
w__wwww__w
