__________
____ww__1_
w___ww___w
__e_.._h__
_._...._._
_._...._._
__h_.._e__
w___ww___w
_2__ww____
__________
