__________
____ww__1_
w___ww___w
__e____h__
_._.__._._
_._.__._._
__h____e__
w___ww___w
_2__ww____
__________
