__________
____ww__1_
w___ww___w
__b_.._b__
_._...._._
_._...._._
__b_.._b__
w___ww___w
_2__ww____
__________
