wwwwwwwwww
w_______1w
w__h_____w
w________w
w_e______w
w______e_w
w________w
w_____h__w
w2_______w
wwwwwwwwww
