wwwwwwwwww
w_______1w
w________w
w________w
w________w
w________w
w________w
w________w
w2_______w
wwwwwwwwww
