wwwwwwwwww
w_______1w
w__h_____w
w________w
w_e______w
w_____e__w
w________w
w____h___w
w2_______w
wwwwwwwwww
