__________
_w_____1w_
____ww____
____bb____
_.b____b._
_.b____b._
____bb____
____ww____
_w2_____w_
__________
