__________
_w_____1w_
_h__ww____
____e_____
_.______.h
h.______._
_____e____
____ww__h_
_w2_____w_
__________
